75 48
2140 300
15 16 16 16 16 16 16 16 16 16 16 16 16 16 16 16 16 16 16 16 16 16 16 16 16 14 20 20 20 27 29 20 20 20 20 20 20 20 20 20 20 20 20 20 20 20 20 27 29 20 20 20 15 16 16 16 16 16 16 16 16 16 16 16 16 16 16 16 16 16 16 16 16 16 14
15 25 25 25 25 25 25 25 25 25 25 25 25 25 25 25 25 25 25 25 25 25 25 25 25 14 20 20 20 20 20 20 20 20 15 16 16 16 16 16 16 16 16 14 20 20 20 20 20 20 20 20 15 24 25 25 25 25 25 25 25 25 25 25 25 25 25 25 25 25 25 25 25 26 14
15 19 19 19 19 19 19 19 19 19 19 19 15 22 22 22 22 22 22 22 30 22 22 22 22 17 16 14 20 20 20 20 20 15 18 24 25 25 25 25 25 25 26 17 16 14 20 20 20 20 20 15 18 21 22 22 30 22 22 30 22 30 22 22 22 22 30 22 22 22 30 22 22 23 14
15 20 20 20 20 20 20 20 20 20 20 20 15 28 28 28 28 28 28 28 28 28 28 28 28 24 25 14 20 20 20 20 20 15 24 21 32 22 22 22 22 32 23 25 26 14 20 20 20 20 20 15 26 27 28 28 28 28 28 28 28 28 28 28 28 28 28 28 28 28 28 28 28 29 14
15 20 20 20 20 20 20 20 20 20 20 20 15 13 0 0 0 0 0 0 0 0 0 0 0 21 22 17 16 16 16 16 16 18 21 21 22 23 33 33 21 30 23 22 22 17 16 16 16 16 16 18 23 13 0 0 0 0 0 0 0 0 0 0 35 37 37 37 37 37 37 37 37 39 14
15 16 16 16 16 16 16 16 16 16 20 20 15 12 0 0 0 0 0 0 0 0 0 0 0 21 22 24 25 25 25 25 25 26 21 27 28 29 34 34 27 28 29 22 22 24 25 25 25 25 25 26 23 12 0 0 0 7 7 0 0 0 0 0 36 38 38 38 38 38 38 38 38 40 14
15 25 25 25 25 25 25 25 25 14 20 20 15 12 0 0 0 0 0 0 0 0 0 0 0 27 28 21 31 22 22 22 31 23 29 7 7 7 41 41 7 7 0 27 28 21 31 22 22 22 31 23 29 35 37 37 39 1 1 35 37 37 37 37 38 38 38 38 38 38 38 38 38 40 14
15 22 22 22 22 22 22 22 22 17 16 16 18 12 0 0 0 0 0 0 0 0 0 0 0 0 0 21 22 22 30 22 22 23 4 1 1 1 1 1 1 1 1 5 0 21 22 22 30 22 22 23 35 38 38 38 40 1 1 36 38 38 38 38 38 38 38 38 38 38 38 38 38 40 14
15 22 22 32 22 30 22 32 30 24 25 25 26 12 0 0 0 0 0 0 0 0 0 0 0 0 0 27 28 28 28 28 28 29 4 1 1 1 1 1 1 1 1 5 0 27 28 28 28 28 28 29 13 4 1 1 1 1 1 1 1 1 1 5 0 0 0 0 0 0 0 0 0 0 14
15 22 22 22 22 22 22 22 22 21 22 33 23 12 0 0 0 0 0 0 0 0 0 0 0 0 0 0 0 0 0 0 0 0 10 1 1 1 1 1 1 1 1 11 0 0 0 0 0 0 0 0 0 10 1 1 1 1 1 1 1 1 1 11 0 0 0 0 0 0 0 0 0 0 14
15 28 28 28 28 28 28 28 28 27 28 34 29 12 0 0 0 0 0 0 0 0 0 0 0 0 0 0 0 0 0 0 0 10 1 1 1 1 1 1 1 1 1 1 11 0 0 0 0 0 0 0 4 1 1 1 1 1 1 1 1 1 1 1 5 0 0 0 0 0 0 0 0 0 14
15 0 0 0 0 0 0 0 0 0 8 1 9 0 0 0 0 0 7 7 7 7 7 7 7 7 7 7 7 7 7 7 10 1 1 1 1 1 1 1 1 1 1 1 1 11 7 7 7 7 7 7 10 1 1 1 1 1 1 1 1 1 1 1 5 0 0 0 0 0 0 0 0 0 14
15 0 0 0 0 0 0 0 0 0 4 1 5 0 0 0 0 10 1 1 1 1 1 1 1 1 1 1 1 1 1 1 1 1 1 1 1 1 1 1 1 1 1 1 1 1 1 1 1 1 1 1 1 1 1 1 1 1 1 1 1 1 1 1 5 0 0 0 0 0 0 0 0 0 14
15 19 19 19 19 19 19 19 19 15 13 1 5 0 0 0 10 1 1 1 1 1 1 1 1 1 1 1 1 1 1 1 1 1 1 1 1 1 1 1 1 1 1 1 1 1 1 1 1 1 1 1 1 1 1 1 1 1 1 1 1 1 1 1 5 0 0 0 0 0 0 0 0 0 14
15 20 20 20 20 20 20 20 20 15 12 1 5 0 0 10 1 1 1 1 1 1 1 1 1 1 1 1 1 1 1 1 1 1 1 1 1 1 1 1 1 1 1 1 1 1 1 1 1 1 1 1 1 1 1 1 1 1 1 1 1 1 1 1 5 0 0 0 0 0 0 0 0 0 14
15 16 16 16 16 16 16 16 16 18 12 1 5 0 10 1 1 1 1 1 1 1 1 1 1 1 1 1 1 1 1 1 1 1 1 1 1 1 1 1 1 1 1 1 1 1 1 1 1 1 1 1 1 1 1 1 1 1 1 1 1 1 1 1 5 0 0 0 0 0 0 0 0 0 14
15 25 25 25 25 25 25 25 25 26 12 1 5 10 1 1 1 1 1 1 1 9 6 6 6 6 6 14 19 19 19 19 19 19 19 19 19 19 19 19 19 19 19 19 19 15 6 6 6 6 6 6 8 1 1 1 1 1 1 1 1 1 1 9 0 0 0 0 0 0 0 0 0 0 14
15 22 31 22 22 22 22 22 33 23 12 1 2 1 1 1 1 1 1 1 9 0 0 0 0 0 0 17 16 16 16 16 16 16 16 16 16 16 16 16 16 16 16 16 16 18 0 0 0 0 0 0 4 1 1 1 1 1 9 6 6 6 6 6 0 0 0 0 0 0 0 0 0 0 14
15 28 28 28 28 28 28 28 34 29 10 1 3 1 1 1 1 1 14 19 19 19 19 19 19 19 15 24 25 25 25 25 25 25 25 25 25 25 25 25 25 25 25 25 25 26 14 19 19 19 19 19 15 1 1 1 1 1 5 0 0 0 0 0 0 0 0 0 0 0 0 0 0 0 14
15 1 1 1 1 1 1 1 1 1 1 1 1 1 1 1 1 1 14 20 20 20 20 20 20 20 15 21 22 22 31 22 33 22 31 22 22 31 22 30 22 22 31 22 22 23 17 16 14 15 16 16 18 1 1 1 1 1 5 0 0 0 0 0 0 0 0 0 0 0 0 0 0 0 14
15 6 6 6 6 6 6 6 6 6 6 8 1 1 1 1 1 1 14 20 20 20 20 20 20 20 15 27 28 28 28 28 34 28 28 28 28 28 28 28 28 28 28 28 28 29 24 25 14 15 25 25 26 1 1 1 1 1 5 0 0 0 0 0 0 0 0 0 0 0 0 0 0 0 14
15 14 20 20 15 0 0 0 0 0 0 4 1 1 1 1 1 1 17 16 16 14 15 16 16 16 18 8 1 1 1 1 1 1 1 1 1 1 1 1 1 1 1 1 1 9 27 28 14 15 28 28 29 1 1 1 1 1 5 0 0 0 0 0 0 0 0 0 0 0 0 0 0 0 14
15 14 20 20 15 19 19 19 19 19 15 4 1 1 1 1 1 1 24 25 25 14 15 25 25 25 26 4 1 1 1 1 1 1 1 1 1 1 1 1 1 1 1 1 1 5 0 0 14 15 13 0 4 1 1 1 1 1 5 0 0 0 0 0 14 19 19 19 19 19 19 19 19 19 14
15 17 16 16 18 20 20 20 20 20 15 4 1 1 1 1 1 1 27 28 28 14 15 28 28 28 29 4 1 1 1 1 1 1 1 1 1 1 1 1 1 1 1 1 1 5 0 0 14 15 12 0 4 1 1 1 1 1 5 0 0 0 0 0 14 20 20 20 20 20 20 20 20 20 14
15 27 28 28 29 20 20 20 20 20 15 4 1 1 1 1 1 1 5 0 0 14 15 13 0 0 0 4 1 1 1 1 1 1 1 1 1 1 1 1 1 1 1 1 1 5 0 0 14 15 12 0 4 1 1 1 1 1 5 0 0 0 0 0 14 20 20 20 20 20 20 20 20 20 14
15 20 20 20 20 20 20 20 20 20 15 4 1 1 1 1 1 1 5 0 0 14 15 12 0 0 0 4 1 1 1 1 1 1 1 1 1 1 1 1 1 1 1 1 1 5 0 0 14 15 12 0 4 1 1 1 1 1 5 0 0 0 0 0 14 20 20 20 20 20 20 20 20 20 14
15 16 16 16 16 16 16 16 16 16 18 4 1 1 1 1 1 1 5 0 0 17 18 12 0 0 0 4 1 1 1 1 1 1 1 1 1 1 1 1 1 1 1 1 1 5 0 0 17 18 12 0 4 1 1 1 1 1 5 0 0 0 0 0 17 16 16 16 16 16 16 16 16 16 14
15 24 25 25 25 25 25 25 25 25 26 4 1 1 1 1 1 1 5 0 0 24 14 19 15 13 0 0 8 1 1 1 1 1 1 1 1 1 1 1 1 1 1 1 9 0 0 0 24 26 12 0 4 1 1 1 1 1 5 0 0 0 0 0 24 25 33 25 25 25 25 25 25 26 14
15 21 22 31 22 22 22 22 22 33 23 4 1 1 1 1 1 1 5 0 0 21 14 20 15 12 0 0 0 6 6 6 6 1 1 1 1 1 1 6 6 6 6 6 6 0 0 0 21 23 12 0 4 1 1 1 1 1 5 0 0 0 0 0 21 22 34 22 30 22 32 22 30 23 14
15 27 28 28 28 28 28 28 28 34 29 28 41 41 41 41 41 41 28 28 28 27 17 16 15 28 28 28 28 28 28 28 28 41 41 41 41 41 41 28 28 28 28 28 28 28 28 28 27 29 28 28 28 41 41 41 41 41 28 28 28 28 28 28 27 28 41 28 28 28 28 28 28 29 14
15 13 0 0 0 0 0 0 0 6 0 0 41 41 41 41 41 41 0 0 0 0 24 14 15 13 0 0 0 0 0 0 0 41 41 41 41 41 41 0 0 0 0 0 0 0 0 0 0 0 0 0 0 41 41 41 41 41 0 0 0 0 0 0 0 0 41 0 0 0 0 0 0 0 14
15 12 0 0 0 0 0 0 0 0 0 10 1 1 1 1 1 1 11 0 0 0 21 14 15 12 0 0 0 0 0 0 4 1 1 1 1 1 1 5 0 0 0 0 0 0 0 0 0 0 0 0 4 1 1 1 1 1 5 0 0 0 0 0 0 0 0 0 0 0 0 0 0 0 14
15 12 0 0 0 0 0 0 0 10 1 1 1 1 1 1 1 1 1 1 11 7 27 14 15 12 0 0 0 0 0 14 15 1 1 1 1 1 1 5 0 0 0 0 0 0 0 0 0 0 0 0 4 1 1 1 1 1 5 0 0 0 0 0 0 0 0 0 0 0 0 0 0 0 14
15 12 0 0 0 0 0 0 10 1 1 1 1 1 1 1 1 1 1 1 1 1 5 14 15 12 0 0 0 0 0 14 15 1 1 1 1 1 1 5 0 0 0 0 0 0 0 0 0 0 0 0 4 1 1 1 1 1 5 0 0 0 14 19 19 19 15 0 0 0 0 0 0 0 14
15 12 0 0 0 0 0 4 1 1 1 1 1 1 1 1 1 1 1 1 1 1 5 14 15 12 0 0 0 0 0 14 15 1 1 1 1 1 1 5 0 0 0 0 0 0 0 0 0 0 0 0 4 1 1 1 1 1 5 0 0 0 14 20 20 20 15 0 0 0 0 0 0 0 14
15 12 0 0 0 0 0 4 1 1 1 1 1 1 1 1 1 1 1 1 1 1 5 14 19 19 19 19 19 19 19 19 15 1 1 1 1 1 1 5 0 0 0 0 0 0 0 0 0 0 0 0 4 1 1 1 1 1 5 0 0 14 17 16 16 16 18 15 0 0 0 0 0 0 14
15 12 0 0 0 0 0 4 1 1 1 1 1 1 1 1 1 1 1 1 1 1 5 17 16 16 16 14 15 16 16 16 18 1 1 1 1 1 1 5 0 0 0 0 0 0 0 0 0 0 0 0 4 1 1 1 1 1 5 0 0 14 24 25 25 25 26 15 0 0 0 0 0 0 14
15 12 0 0 0 0 0 4 1 1 1 1 1 1 1 1 1 1 1 1 1 1 5 24 25 25 25 14 15 25 25 25 26 1 1 1 1 1 1 11 7 7 7 7 7 7 7 7 7 7 7 7 10 1 1 1 1 1 5 0 0 14 27 32 28 32 29 15 0 0 0 0 0 0 14
15 12 0 0 0 0 0 0 8 1 1 1 1 1 1 1 1 1 1 1 1 9 0 21 22 31 22 14 15 22 31 30 23 1 1 1 1 1 1 1 1 1 1 1 1 1 1 1 1 1 1 1 1 1 1 1 1 1 5 0 0 14 20 20 20 20 20 15 0 0 0 0 0 0 14
15 12 0 0 0 0 0 0 0 8 1 1 1 1 1 1 1 1 1 1 9 0 0 27 28 28 28 14 15 28 28 28 29 8 1 1 1 1 1 1 1 1 1 1 1 1 1 1 1 1 1 1 1 1 1 1 1 9 0 0 0 17 16 16 16 16 16 18 0 0 0 0 0 0 14
15 12 0 0 0 0 0 0 0 0 8 1 1 1 1 1 1 1 1 9 0 0 0 0 0 0 0 14 15 13 0 0 0 0 6 6 6 6 6 6 6 6 6 6 6 6 6 6 6 6 6 6 6 6 6 6 6 6 0 0 0 24 25 25 25 25 33 26 13 0 0 0 0 0 14
15 12 0 0 0 0 0 0 0 0 0 6 8 1 1 1 1 9 6 0 0 0 0 0 0 0 0 14 15 12 0 0 0 0 0 0 0 0 0 0 0 0 0 0 0 0 0 0 0 0 0 0 0 0 0 0 0 0 0 0 0 21 31 22 31 22 34 23 12 0 0 0 0 0 14
15 12 0 0 0 0 0 0 0 0 0 0 4 1 1 1 1 5 0 0 0 0 0 0 0 0 0 14 15 12 0 0 0 0 0 0 0 0 0 0 0 0 0 0 0 0 0 0 0 0 0 0 0 0 0 0 0 0 0 0 0 27 28 28 28 28 41 29 12 0 0 0 0 0 14
15 12 0 0 0 0 0 0 0 0 0 0 4 1 1 1 1 5 0 0 0 0 0 0 0 0 0 14 15 12 0 0 0 0 0 0 0 0 0 0 0 0 0 0 0 0 0 0 0 0 0 0 0 0 0 0 0 0 0 0 0 0 0 0 0 0 41 0 0 0 0 0 0 0 14
14 19 19 19 19 19 19 19 19 19 19 19 15 1 1 1 1 14 19 19 19 19 19 19 19 19 19 19 19 19 19 19 19 19 19 19 19 19 19 19 19 19 19 19 19 19 19 19 19 19 19 19 19 19 19 19 19 19 19 19 19 19 19 19 19 19 19 19 19 19 19 19 19 19 15
17 16 16 16 16 16 16 16 16 16 16 16 18 1 1 1 1 17 16 16 16 16 16 16 16 16 16 16 16 16 16 16 16 16 16 16 16 16 16 16 16 16 16 16 16 16 16 16 16 16 16 16 16 16 16 16 16 16 16 16 16 16 16 16 16 16 16 16 16 16 16 16 16 16 18
24 25 25 25 25 25 25 25 25 25 25 25 26 1 1 1 1 24 25 25 25 25 25 25 25 25 25 25 25 25 25 25 25 25 25 25 25 25 25 25 25 25 25 25 25 25 25 25 25 25 25 25 25 25 25 25 25 25 25 25 25 25 25 25 25 25 25 25 25 25 25 25 25 25 26
27 28 28 28 28 28 28 28 28 28 28 28 29 37 37 37 37 27 28 28 28 28 28 28 28 28 28 28 28 28 28 28 28 28 28 28 28 28 28 28 28 28 28 28 28 28 28 28 28 28 28 28 28 28 28 28 28 28 28 28 28 28 28 28 28 28 28 28 28 28 28 28 28 28 29